NO ./assets/walls/stone_wall_01.xpm
SO ./assets/walls/stone_wall_01.xpm
WE ./assets/walls/stone_wall_01.xpm
EA ./assets/walls/stone_wall_01.xpm

F 120,120,120
C 90,90,90

1111111111111111111111111
110000000111S111100011111
1101111111110101111000001
1100001111110101111111101
1111101111110100000000001
1111101111110111111111101
1000000000000000000000001
1011111111110111111111111
1011111111110000111111111
1011111111111110111111111
1000000011111110111111111
1011111111111110111111111
1011111111110000111111111
1000000111110111011111111
1111110111110111011111111
1111110111110000011111111
1111110000000111111111111
1111111111111111111111111



