


NO ./path_to_the_north_texture.xpm
SO ./path_to_the_south_texture.xpm
WE ./path_to_the_west_texture.xpm



EA ./path_to_the_east_texture.xpm

F 250,100,0
C 225,30,0


  11111
1110001
1000N0111
10000001
1011110011
111  1111