NO ./assets/walls/stone_wall_01.xpm
SO ./assets/walls/blue_wall_01.xpm
WE ./assets/walls/stone_wall_01.xpm
EA ./assets/walls/stone_wall_01.xpm

F 120,120,120
C 90,90,90

111111111111111
100000000000101
10000100W000101
111100000010101
100000000010101
100000001111101
100000000000001
100000000000001
111111000111101
100000000000001
111111111111111