NO ./assets/walls/iron_wall_07.xpm
SO ./assets/walls/blue_wall_01.xpm
WE ./assets/walls/stone_wall_02.xpm
EA ./assets/toto.xpm

F 188,56,123
C 123,56,188

 11111111111111
100000000000101
10000100S000101
111100000010101
100000000010101
100000001111101
100000000000001
100000000000001
111111000111101
100000000000001
11111111111111