


NO ./assets/walls/blue_wall_01.xpm
SO ./assets/walls/blue_wall_02.xpm
WE ./assets/walls/blue_wall_02.xpm
EA ./assets/walls/blue_wall_01.xpm


F 250,100,0
C 225,30,0


   11111111111111111111111111111111111111111111111111111111111
1110000000000000000000000000001111111111111100001111111111110111
1000S01110000000000000000000000000001111111111111111111111111101
1000000000000000000010000000000000000000011111111110111111111111
100000000000111111111111110000100000000000000111111111101
100000000011111111111111110000000000000000000001111111101
10000000001111111001111111000000000000000000111111110111
100000000011111111111111110000000000000000011111111011
10000000001111111111111111000000111111110111111111111
100000111111111001111110000000000001111101111111111111111111111111111111
100000000000001101111111110000000011111101
100000000000001101111  1110000000011111101
100000000000001101111111110000000011111101
100000000000001101111111110000000011111101
100000000000001101111111110000000011111101
1110000000000000000000000000000000000000001111
111100000000000000000000000000000000000000000111111
1111000000000000000000000000000000000000000000001111
1110000000000000000010000000000000000000000000011111
1111000000000000000000000000000000000000000000000001
1111100000000000000000000000000011111111111111000001
1011110011111111111111111111111111111111111111111101
111   111111111111111111111111111111111111111111111