


NO ./assets/walls/blue_wall_01.xpm
SO ./assets/walls/blue_wall_02.xpm
WE ./assets/walls/blue_wall_02.xpm
EA ./assets/walls/blue_wall_01.xpm


F 250,100,0
C 225,30,0


  1111111111111111111111111111111111111111
111000000000000000000000000000111111111101
1000S0111000000000000000000001111111111101
100000000000000000001000000000111111111101
100000000000111111111111110000111111111101
100000000011111111111111110000001111111101
100000000011111110011111110000001111111101
100000000011111111111111110000001111111101
100000000011111111111111110000001111111101
100000111111111001111110000000000001111101
100000000000001101111111110000000011111101
100000000000001101111111110000000011111101
100000000000001101111111110000000011111101
100000000000001101111111110000000011111101
100000000000001101111111110000000011111101
1110000000000000000000000000000000000000001111
111100000000000000000000000000000000000000000111111
1111000000000000000000000000000000000000000000001111
1110000000000000000010000000000000000000000000011111
1111000000000000000000000000000000000000000000000001
1111111110000000000000000000000011111111111111000001
1011110011111111111111111111111111111111111111111111
111  1111