NO ./assets/walls/blue_wall_01.xpm
SO ./assets/walls/blue_wall_02.xpm
WE ./assets/walls/blue_wall_02.xpm
EA ./assets/walls/blue_wall_01.xpm

F 188,56,123
C 123,56,188

111111111111
1000E0000101
111111111111