


NO ./assets/walls/blue_wall_01.xpm
SO ./assets/walls/blue_wall_02.xpm
WE ./assets/walls/blue_wall_02.xpm


EA ./assets/walls/blue_wall_01.xpm

F 250,100,0
C 225,30,0


  1111111
1110000001
1000N011101111111
10000010000000001
1000000000001111
1000000000111
100000111111111
100000000000001
101111001111111
111  1111